NO img/img1.xpm
SO img/img2.xpm
EA img/img3.xpm
WE img/img3.xpm
F 220,100,22
C 225,30,22

111111
100001
101101
1000N1
111111